tropical = {
	1120 1113 1119 2894 1123 1125 2911 2192 2906 2966														# Gold coast
	1134 2769 1131 2788 1552 2790 1549 2779 1141 1139 2775 5220 3816 1138 2776								# Niger
	4272 1204 4280 																							# Central Africa
	3898 1227 1527 1226 1519 1232	 																		# Madagascar
	5292 573 2336 3157 3156 2570 5296 534 533 5298 532 3151 531 3150 3145 4056 2569 3144 529 3201 			# Subcontinent
	3191 567 3190 2699 3194 3192 568 4219 585 3214 2823 5360 4046 590 4043 3221 579 586 2426 3215 2822 3218	# Burma
	4049 591 3222 3930																						# Siam
	593 3236 592 4216 594 3237 2824 2735 2736 2737 595 599 2828 2830 3315 598 3239 596 3910 597 407 4047 	# Malaysia
	574 420 2103 2102 2101 617 2093 3911 3912 3913 2098 2094 618 3915 3917 2097 3914 3940 2095 2099 3916 	# Sumatra
	619 2096 3918 3920 620 3919 621 623 622 2100 3921 659 													# Sumatra
	3922 624 2108 3923 3924 2107 630 3925 2109 3927 625 4239 2110 3926 4237 626 2106 627 					# Java
	2092 3342 629 2090 2089 640 3341 639 638 3339 738 3340 637 636 3929 2091 651 655 						# Bornéo
	657 2217 2216 2215 658 654 2214 656 2213 652 653 2586 													# Philippines
	649 648 2430 2431 645 647 646 1042 716 633 634 4044 2433 641 4042 4045 2432 2589 1238 2590 1239 650		# Moluccas
	642 644 643 3928 1245 2088 714 777 1234 2585 3446 1237 3450 3448 773 3343 3344 1236 2588 1242 1230 3345	# Moluccas
	2587 1235 1233 1231 1246 1241 5234 1097 1243 513 5239 4012 4013 1244 5238 5236 2608						# Moluccas
	3313 2734 3931 2417 2418 3232 3934 611 2419 3233 5225 2396 3229 4214									# Indochina
	3467 3470 756 3476 749 3490 748 3491 1484 742 2074 3493 1483 3494 747 746 1482 3495 745 				# South America
	828 1490 3496 744 743 2076 2079 2077 2080 2087 3405 3406 818 824 1476 1478 825 2081 					# South America
	2084 821 3506 832 1475 826 833 808 2338 2341 814 823 792 1479 835 3492 2752 764 3464					# South America
	3507 836 2209 838 837 1473 2416 3511 2646 3516 1472 3518 844 840 842 1709 2602 2599 1710 3509 843 3517	# Central America
	1474 4041 848 2598																						# Central America
	487 489 1538 492 926 1540 1537 1536 502 2593 2594 501 2595 500 499 498 497 496 495 494 2596 493			# Caribbean
}

arid = {
	342 345 346 349 355 359 380 383 384 385 386 387 388 389 394 395 396 397 400 401 402 403 404 2235   
	428 434 437 438 439 441 443 448 462 465 466 467 468 469 470 471 473 474 5310 430 
	512 551 575 576 577 578 717 718 739 810 865 866 867 881 882 1098 1115 1116 1147 2943 4096 478 452 
	1148 1158 1160 1162 1167 1208 1210 1211 1212 1324 1331 1332 1339 1466 1500 1516 1524 1526 4058 5311 
	1535 1543 1545 1547 1548 1559 1583 1733 1823 2066 2118 2119 2139 2167 2257 2268 3319 1225 
	2316 2342 2503 2504 2520 2527 2538 2539 2575 3009 3027 3432 2638 1491 2639 2651 2652 1221 
	2657 2658 2659 2660 2661 2665 2715 2718 2719 2740 2741 2743 2745 2746 2747 2771 477 
	2772 2807 2808 2809 2810 2811 1523 2497 2870 2936 2937 2915 2920 2923 2928 2929 2930 2931 2949 4095 
	2938 2939 2999 3068 3069 3070 3071 3073 3074 3075 3076 3077 3099 3100 3121 3210 3274 3282 3306 
	3284 3295 2954 3430 3431 3887 1330 3072 3901 1582 3317 1168 5229 5230
	3830 3832 2229 3833 3834 3094 3097 3095 3433 3445 3902 4039 4030 4115 4116 5508 2349
	2509 519 2720 3411 804 786 1099 879 2347 2348 2350 446 390
	2351 3211 3275 2267 3268 3213 2742 3305 2273 2650 2934 4232 3286 2725 3058 3040 1575 3006 
	1571 3015 1202 3043 3024 2792 2951 2952 1209 1572 1216 1574 3066 3320 1215 3318 3035 1149 1224 
	1218 2953 1182 3061 3055 3036 3037 3038 3039 1200 3050 3053 3054 1205 3052 3060 3049 1201 3047 3044 
	3046 3051 3022 3042 3020 3064 5243 2964 2904 1118 2959 2908 2918 1563 1081 3312 3299
	2221 3296 3298 3297 455 3844 3440 3441 2345 806 809 812 3414 816 862 4122 5160 4117
}

arctic = {
	1530 978 2193 2191 3670 2190 2189 975 3669 3665 909 3663 1010 3661 1002 3666 998 3570 	# North America
	1004 1005 3662 2168 2161 1517 3653 2196 3638 1003 994 996 1000 2481 991 3668 3667 3580 920 1462 3582	# North America
	3629 3630 2180 981 980 3634 890 985 3640 3652 3651 3650 946 3658 3659 1008 3655 1011 2169 3660 1007		# North America
	1001 3656 992																							# North America
	1104 371 370 10 891 1260 1266 1255 2327 3997 19 30 29 31 1261 1262 11 4 								# Scandinavia
	315 35 33 3994 291 314 288 279 278 4203 4208 1072 4209 1529 4206 4205 4204 4202 1075 1078 1074 			# Siberia
	2152 2445 4200 2153 1066 1065 1064 1063 1060 2156 1062 3271 1059 1061 4197 3270 4196 1056 1054 3255 	# Siberia
	1052 2154 4195 1055 1051 2158 2157 4194 2155 3253 721 1044 1040 1039 1038 1037 1035 1036 1034 4023		# Siberia
	2744 1049 3248 2302 																					# Manchuria
	1095 782 783 																							# Magellan Strait
	2258 2260 3209 2259 3208 																				# Eastern China

    4309 4308 1589 4358 4330 1781 2062 4313 1861 1590 2063                                             # Waters (heavy)
    2064 2023 3975 4311 4310 1862 4284 4307 4329                                                            # Waters (medium)
    4328 4285 2061 2060                                                                                # Waters (light)
    5183 5184 2482 5199 5200                                                                           # Wastelands (heavy)
    5185                                                                                                    # Wastelands (medium)
}

mild_winter = {
	3998 23 20 25 2515 6 12 2755 1428 14 67 375 3331 3330 3329 374 3328 2529 373 3335 3334 372 3327 3332 
	3333 376 233 1411 3326 239 247 241 3323 1412 242 1514 3337 249 252 3719 253 1417 3338 369 3396 90 87 
	2353 88 63 2307 167 89 1387 3375 4186 1335 183 2365 192 2241 127 2852 2851 1247 2534 120 2856 2532 
	2531 2562 121 2533 122 2857 119 2858 3869 2530 118 1379 3701 3702 105 1414 3700 2453 3867 114 1378 
	113 106 116 2563 3699 117 3698 1415 3868 3697 1380 115 2564 101 1513 102 1376 103 3703 1377 2624 104 
	2611 1390 1347 1346 3866 2372 3381 1345 109 108 3382 1348 112 107 1858 111 1355 129 2452 130 4034 201 
	3377 3860 1382 1512 2335 202 200 1383 203 976 1323 3373 196 3862 3861 197 212 2565 220 1284 3359 
	181 213 2368 1420 2369 3368 211 3369 214 2473 1408 3361 3363 3365 2567 3370 210 2514 343 339 
	2932 1522 2933 2935 2934 1515 344 4072 347 4075 224 2311 3357 3358 227 3360 3362 225 3356 2448 1423 
	229 3347 2308 231 1508 1422 3349 232 3350 2454 3351 3352 207 171 2329 4008 169 2240 168 2330 177 
	1421 209 2566 2361 2550 1381 175 176 174 3372 357 194 173 2239 172 1388 2234 178 180 195 935 925 900 
	1384 190 2332 191 391 1447 2362 3374 1386 2356 1298 3795 1299 2573 1344 2274 3877 3881 1326 2574 1441 
	184 328 330 1437 2541 3878 323 2553 1446 3388 2552 4067 3387 3386 317 318 4066 3389 319 326 2542 4062 
	324 322 4061 331 329 3879 2540 1333 1443 1440 2551 1444 4028 4029 1445 2219 2559 2227 1315 1314 3078 
	418 3079 2225 429 414 464 3831 435 3836 3082 316 3959 2281 3973 2280 2283 3954 2796 3958 2282 
	3957 1021 1027 3967 3965 1026 3966 1029 1023 1022 3968 1024 3964 1030 1032 3969 1033 2279 3960 3961 
	1143 2510 664 2793 1337 2797 665 685 686 2145 2494 2477 712 3977 
	2480 684 1172 3810 3090 3823 417 3824 426 405 3840 3849 387 2220 2170 687 688 690 2613 2144 691 
	695 2149 2150 2125 2147 693 2493 1089 1046 1068 694 869 1824 3683 3688 938 3609 930 953 952 950 2176 
	904 3610 1451 3611 932 3605 3600 923 3602 924 3590 3589 3562 3561 3560 3559 895 3550 886 882 857 855 
	2641 883 2404 2405 850 2645 2203 2600 2601 899 3564 3563 3588 942 922 3601 3591 3555 3556 3557 3558 
	223 3005 170 4184 4119 3695 5415 5408 5407 5398 5400 5399 5401 5425 5435 
	5392 5393 5394 5395 5396 5397 5405 5406 5475 5449 5451 5450 5461 5462 5463 5464 5465 5466 5467 5468 
	5505 5506 5417 5416 

    4328 2061 2060																						# Waters (light)
}

normal_winter = {
	18 26 7 24 21 17 16 1256 5 2836 3762 283 3764 3763 2506 271 3759 2816 256 1531 3758 4026 257 1391 1844 
	2355 42 2398 4025 43 2845 48 2849 2834 264 2844 2847 47 2843 3817 72 3821 3820 57 3818 46 3819 1353 45 
	44 1252 3722 3721 13 3754 3720 15 96 2360 2367 92 2363 91 2354 3376 193 4228 2366 2385 204 205 199 
	68 236 235 1410 234 237 240 427 244 409 3336 248 2512 250 251 1416 246 238 245 3324 3325 243 1283 2386 
	3859 399 2754 2850 258 259 1279 2833 2536 262 3757 2832 263 2400 2815 255 2399 3756 2814 254 2401 2835 
	4003 4002 2561 2633 1359 4001 1278 4000 3999 269 3752 84 265 3751 3750 270 2831 60 266 3749 1277 3748 
	268 267 3747 2384 128 2383 132 134 1510 83 1404 3789 1271 2275 1405 3755 1406 3770 1275 3772 1859 
	1270 1267 1272 1276 3753 1274 2436 3769 153 133 135 2846 152 2390 2391 2612 3773 3775 1397 140 3777 148 
	2124 3779 1591 3780 1427 3776 2382 1426 157 1848 3781 2381 150 159 3782 2380 2376 3787 1398 2377 3785 
	161 3786 3783 3784 2378 3791 2379 1269 160 1400 3794 284 4019 4021 300 1431 285 302 282 286 287 3796 
	1302 4114 303 1303 2656 2578 3797 2579 425 424 3811 2549 1300 3799 3800 3798 1301 423 422 2576 3808 65 
	1317 1449 3801 4027 3804 3807 2577 3809 463 1318 1321 416 3394 3395 3803 3883 3882 2664 3393 3884 1442 
	336 95 2370 97 98 99 1372 1371 2450 4004 973 100 55 1357 54 53 1352 1364 3724 56 3726 86 2451 93 
	2364 186 1511 94 1362 1363 188 187 189 2812 4006 75 4005 4007 1356 2359 69 74 1349 3378 2616 78 1370 
	3771 1273 2137 3774 141 139 1268 2389 131 2331 2197 997 62 76 3857 4011 1351 3746 3858 64 3856 1509 2614 2795 
	82 3379 1358 77 80 2615 2622 81 1360 3734 4010 58 1366 3735 3736 974 70 1367 2187 2637 2623 51 1361 
	4009 1253 1368 85 156 2449 2756 3732 1365 3733 3812 3731 2757 79 3730 1369 3725 3813 61 3729 3727 3728 
	2618 49 3822 71 3380 2813 3741 3737 3814 3855 2619 3740 3852 3851 2617 3850 1373 1350 3738 52 66 2621 
	3745 4015 50 2620 3742 3743 59 2299 2300 1025 1019 3739 3853 3854 3815 2284 3953 3952 2285 
	2286 2290 2291 3947 2295 3944 2298 3943 3945 2296 2297 2277 2293 3950 3949 3948 3946 2292 2294 2287 
	3956 2288 3955 3951 2289 3974 2435 3962 1031 1028 3963 2607 2472 2605 2252 2256 2255 2162 2257 2119 
	2267 2254 689 718 719 2804 736 2805 2233 2803 1006 2159 3654 3723 3744 2334 5156 
	735 2806 734 2802 733 2801 730 2249 4035 4036 4037 3241 3242 4031 731 3258 2266 4038 2248 707 713 
	3240 706 2265 3263 708 578 451 3842 449 2745 2741 2746 2118 3210 3211 739 737 
	704 705 724 703 2491 2560 698 2148 696 699 2492 697 1041 2485 701 702 2471 2467 2246 700 
	2476 2468 2251 2743 3213 2742 478 2273  460 459 3302 3305 3306 3303 461 477 2223 3311 
	3296 3299 2221 3298 3297 2232 3301 3847 476 3292 458 3291 3274 4187 2269 4188 2747 3672 972 
	870 872 3679 2184 3678 876 3676 3677 2185 1823 2199 2167 3685 3603 3604 3612 3613 3614 2178 
	936 954 916 961 962 1452 963 2177 939 965 966 3687 2465 980 981 982 984 3632 3633 983 2182 1458 2179 
	971 970 968 3691 3628 969 964 3627 3623 3626 959 955 1459 960 1454 3587 3586 951 3585 949 934 3565 
	918 898 3566 903 3568 1460 3575 902 3576 2172 915 914 937 3581 3675 3631 967 901 1494 917 3577 941 
	1493 943 944 958 3584 3583 3618 2785 956 3617 3615 3616 3621 3622 3620 3619 3624 3625 957 920 945 3647 
	3646 179 3371 1385 1375 3567 3681 3684 3680 3682 894 5452 5477 5495 5454 
	5371 5372 5373 5374 5375 5376 5377 5379 5380 5381 5382 5383 5384 5385 5386 5387 5388 5389 5390 5391 5402
	5403 5404 5470 5469 5472 5479 5480 5481 5482 5483 5484 5487 5488 5489 5490 5491 5493 5494 5378 5492 5471 
	5478 5474 5473 5476	1009 995 3639 999 1822 732 2461 889 877 977 3863 

    2064 2023 4329 3975 4311 4310 1862 4284 4307                                                           # Waters (medium)
    5185                                                                                                    # Wastelands (medium)
}

severe_winter = {
	10 11 19 22 29 30 31 33 35 73 110 165 166 185 277 278 279 281 288 289 290 291 292 293 294 295 297 298 
	299 301 304 305 306 307 308 309 310 311 312 313 314 315 370 371 381 450 453 508 509 523 554 557 562 565 
	740 782 783 784 873 874 891 906 908 909 910 911 912 913 946 947 948 975 978 987 988 985 890 
	989 990 991 992 993 994 996 998 1000 1001 1002 1003 1004 1005 1007 1008 1010 1011
	1035 1036 1037 1038 1039 1040 1044 1045 1047 1051 1052 1054 1055 1057 1059 1060 1062 1063 1064 1065 1066 1067 
	1069 1070 1071 1072 1074 1075 1077 1078 1079 1080 1082 1104 1194 1217 1250 1251 1254 1255 1260 1261 1262 
	1266 1286 1288 1289 1290 1291 1292 1294 1295 1296 1305 1306 1307 1308 1310 1311 1343 1374 1389 1448 
	1489 1517 1529 1530 1865 2114 2115 2116 2120 2122 2143 2152 2153 2154 2155 2156 2157 2158 2160 2161 
	2168 2169 2171 2186 2188 2189 2190 2191 2193 2196 2198 2259 2261 2262 2263 2264 2327 2437 
	2438 2439 2440 2441 2442 2443 2444 2445 2446 2546 2547 2548 2580 2582 2583 2625 2691 2692 2700 2701 
	2722 2748 2333 2447 2455 2456 2457 2458 2466 2474 2475 2479 2481 2840 2841 3105 3107 3110 
	3112 3113 3193 3197 3198 3205 3206 3207 3208 3322 2195 3670 3669 3668 3673 3674 3667 3666 3665 
	3664 3570 905 3571 3572 3573 3574 3580 3579 3578 3663 3661 3660 3659 3658 3653 3655 3656 1462 3569 
	3582 3643 3648 3650 3651 3652 3649 3645 3644 3641 3640 3638 3637 3662 3981 3982 3983 2671 3629 
	3984 3985 3986 3987 3988 3989 3990 3991 3992 3993 3994 3997 4016 4017 4023 4022 4111 4112 3212 4100 
	4102 4189 4190 4191 4192 4193 4194 4195 4196 4197 4198 4199 4200 4201 4202 4203 4204 4205 4206 4207 4208 
	4209 4 8 1259 1 9 27 28 32 1258 2 3 1257 3401 34 3400 36 3767 3768 1354 3766 274 1263 37 3399 1430 
	3765 273 3980 1264 38 39 1432 1265 40 1280 1394 3398 3397 272 2842 275 1393 2848 276 261 280 2839 2837 
	1395 2838 1433 2626 3793 2236 260 3792 2537 3788 158 3790 162 480 1282 2507 2535 1281 3760 3761 1429 296 
	1450 3802 2581 419 3805 3806 1316 1293 4113 3287 1083 3310 1081 1073 2375 1309 1304 1297 4020 1287 
	2545 4110 4018 3285 3312 471 3304 3309 479 3277 3308 472 475 1076 1312 4024 41 1034 2302 2301 2744 2328 
	3245 3248 1049 3249 4032 3247 1050 3250 3276 2270 2271 3272 1061 3271 3270 1056 3269 721 3257 3261 1058 
	729 3254 3253 4033 3255 3251 1048 727 3252 3246 728 3244 3243 660 666 2463 3209 2260 2258 4124 4125 
	2740 3300 3848 1465 1464 3642 2180 3636 3635 2183 3634 986 3630 940 3686 2800 2798 4240 3283 5485 
	723 3256 726 725 3260 3265 3264 3266 3267 715 717 3273 4039 2268 3262 3259 720 2253 3268 722 3275 709 2247 
	4099 2799 5155 

    4309 4308 1589 4358 4330 1781 2062 4313 1861 1590 2063 1850                                        # Waters (heavy)
    5183 5184 2482 5199 5200                                                                           # Wastelands (heavy)
}

impassable = {
	365 406 740 1152 2143 2333 2447 2455 2456 2457 2458 2459 2465 2466 2474 2479 2482 2483 2487 
	2489 2495 2505 2508 2509 2511 2513 2517 2697 2747 2761 2798 2799 2901 3212 3545 3704 3705 3706 3835 3282 
	3837 3880 3941 4022 438 3274 3295 4051 4052 4053 4054 4055 4076 4077 4081 4082 4083 4084 4085 4086 4087
	4088 4089 4090 4099 4100 4101 4102 4103 4118 4119 4120 2791 1197 1179 4126 4127 4128 
	1045 4184 4185 4187 4188 4189 4190 4191 4192 4193 4207 4210 4220 4221 4222 4224 4225 4226 4227 2269 
	4229 4230 1312 1324 443 4233 3121 4235 4236 4238 4240 4281 2667 3846 3027 2954 2222 2441 277 
	2223 3304 3309 3283 5226 5241 1590 1781 1861 2525 2609 2610 4330 2160 2475 5507 
	5245 5246 5247 5248 5249 5250 5350 5351 5359 5361 5362 5363 5364 3673 
	5452 5453 5454 5477 5485 5486 5495 5502 5503 718 786 5232 5233 5224 
	5141 5144 5145 5146 5147 5148 5149 5150 5151 5152 5153 5155 5158 5159 
	5161 5162 5163 5165 5166 5168 5169 5172 5173 5176 5177 5178 5179 5180 
	5181 5183 5184 5185 5186 5190 5191 5193 5194 5195 5196 5197 5198 5199 5200 
	5201 5202 5204 5205 5206 5207 5209 5210 5212 5213 5214 5215 5216 5217 
}

mild_monsoon = {
	#Far East
	5429 5428 5424 5426 712 5425 693 5417 2493 691 695 5408 5415 3977 2147 2125 2607 5395 5394 5393 5398 1068 694 
	5401 5400 5399 1046 5416 1822 1021 1020 1017 1018 2278 3970 1027 3967 1026 3966 1029 1030 3964 1032 2295 3944 
	3943 2298 3945 2296 2297 
	#Indochina
	608 3933 609 3226 3930 4215 2820 2668 603 2306 600 602 2421 2821 3909 2670 2321 601 2422 3908 586 2426 3215 
	2822 3216 2425 2428 580 569 3903 3217 2429 584 3906 588 587 3905 2427 3904 352 2728 2727 2324 4218 3219 2322 
	3220 
	#Indonesia
	1094 2134 2213 652 617 3912 2093 3911 
	#India
	2337 572 2336 3124 2710 3199 2713 2712 3238 536 3158 538 5294 537 2673 5300 539 1520 5297 5295 2674 2629 2245 
	542 3159 4078 5301 541 2672 2628 507 3160 546 3162 5306 3163 5307 5308 3166 3168 3143 527 3146 2243 3164 3165 
	2681 518 2707 526 3117 2706 3120 3115 521 3114 3111 5329 3106 564 510 5328 3109 2113 3102 5299 2676 2675 3154 
	540 5302 4079 3153 3155 547 2677 544 543 2678 1587 530 2212 5303 545 3161 
	#Africa
	3895 3896 4245 2991 1192 1492 1193 1189 1507 1578 4246 4248 5223 2981 2879 2975 1155 2974 5219 1157 2979 2980 
	1159 1156 4267 1153 4264 4263 4262 4261 4258 4259 4260 4265 4266 4253 4250 4274 4273 2218 2194 2871 1114 1221 
	1563 2946 1133 1560 2950 2948 2926 2927 2925 1137 1122 1553 1554 1555 2895 2794 2780 2960 2961 2963 1129 2781 
	1105 2902 1495 2958 2914 2957 2910 2766 1525 1124 1121 2899 2765 1542 2770 2893 
	#South America
	751 3489 749 3490 750 2071 3460 3461 3459 769 766 3464 764 3463 3462 763 3465 3468 770 768 3456 
}

normal_monsoon = {
	#Far East
	671 2073 2117 710 675 673 674 3939 2464 711 5441 677 676 5440 2121 678 5437 5436 2486 679 2488 5420 1053 5418 
	5419 5421 680 2606 5422 5423 2484 2490 5410 5411 2142 692 2141 5409 5412 5414 5413 2272 2145 2494 1089 2304 
	2305 2303 1012 1013 1014 1015 1016 3972 2276 877 737 2804 889 2461 736 2805 2806 734 2803 2233 735 2802 733 
	2801 1023 1022 3968 1024 3969 3965 1028 3963 3962 1031 3961 2279 3960 2281 3973 2280 3959 2283 3961 1033 3954 
	2796 3958 2282 3957 3947 2291 2285 3952 3953 2284 2435 3956 2288 3974 2290 2289 3955 3951 2277 3950 3949 3948 
	2293 3946 2292 2294 2287 2286 
	#Indochina
	2819 3227 3313 2734 3228 604 3931 3932 2417 2827 605 606 4214 2317 3229 607 2318 2397 3230 2418 2419 2396 610 
	4211 2731 3937 2325 3314 616 2395 3936 613 3938 2393 2394 
	#Indonesia
	595 2830 3239 596 3913 2098 2094 2097 3917 618 3914 3940 3915 2099 2095 3916 620 4047 2108 3924 630 2109 2111 
	628 626 2105 2106 2104 627 631 632 633 907 635 1642 716 1042 646 645 2430 2431 648 6492586 3928 643 2432 2585 
	638 3339 655 653 656 2214 2215 658 2216 2217 657 644 1237 3344 3343 773 1236 2588 2136 799 649 3448 3450 
	#India
	421 515 516 520 522 524 528 533 534 535 550 553 555 558 559 560 573 582 1248 2163 2210 2211 2244 2555 2557 
	2558 2570 2627 2630 2632 2679 2680 2684 2688 2689 2690 2702 2703 2704 2705 2708 2709 2711 2714 2723 2739 3116 
	3118 3119 3125 3126 3127 3128 3129 3130 3131 3132 3133 3134 3135 3136 3137 3138 3139 3140 3141 3142 3147 3148 
	3149 3156 3157 3167 3174 3175 3176 3178 3179 3180 3181 3182 3195 3196 3197 3201 3202 3204 5292 5293 5296 5298 
	5304 5305 5309 5316 5317 5318 5319 5320 5323 5324 5325 5330 5331 5332 5333 5334 5335 5336 5337 5338 5339 5340 
	5341 5342 5343 5344 5345 5352 5353 
	#Africa
	979 1100 1101 1102 1103 1110 1125 1126 1127 1128 1140 1142 1144 1145 1146 1151 1154 1177 1180 1181 1184 1185 
	1186 1187 1188 1190 1191 1196 1204 1226 1228 1229 1496 1502 1503 1504 1505 1518 1528 1550 1551 1556 1557 1558 
	1561 1562 1564 2758 2759 2760 2762 2767 2775 2778 2785 2787 2789 2874 2875 2876 2877 2878 2880 2883 2884 2886 
	2887 2888 2890 2891 2892 2897 2898 2900 2911 2912 2973 2976 2977 2978 2982 2983 2984 2985 2986 2987 2988 2994 
	3671 3893 3894 3899 3942 4243 4244 4247 4249 4251 4252 4254 4255 4257 4269 4270 4271 4275 4276 4277 4278 4279 
	4280 4281 4282 4283 5136 5218 2872 2773 1527 
	#South America
	1483 3492 742 2076 1484 3491 748 2752 2079 2081 2075 762 761 3466 3467 757 767 765 3457 
	#Polynesia
	2527 4014 506 4013 1097 513 1243 2608 1244 5235 5236 5237 1108 1107 1106 822 1249 1109 1240 2151 1341 4012 5238 
	5239 1242 650 1239 2590 1238 1241 1246 1232 2012 2587 1235 1230 654 4081 
}

severe_monsoon = {
	#Indochina
	4219 585 3214 579 5360 2823 4046 3218 590 4043 2825 3223 3221 2420 4050 4049 591 3222 593 2738 3236 592 4216 594 
	3237 2736 2737 2824 2735 599 2828 3315 598 3910 597 4048 
	#Indonesia
	2101 2102 2103 619 2096 3918 3919 621 623 622 2100 3920 3921 659 624 3922 3923 2107 3925 625 3927 2110 4239 3926 
	4237 634 647 2434 4044 2433 4045 642 4042 641 639 3341 640 2089 2090 629 3342 2092 2091 3929 636 637 738 3340 
	3446 777 1234 714 2088 1245 3345 2513 2511 2697 
	#India
	517 2568 529 3144 2569 4056 3145 3150 531 3151 3152 532 2682 552 5322 3200 3177 5321 548 2683 3172 3173 549 556 
	2687 2686 3171 2554 3170 3169 2685 5326 5244 561 5249 563 3190 568 3192 3194 2699 567 2698 570 571 566 2695 3186 
	2694 5354 3185 3184 2693 5346 5326 1588 5347 5348 5357 2696 5358 3191 3189 5356 3203 5355 3187 3188 3183
	5349 
	#Africa
	3897 3898 1227 1519 1521 5220 1141 1139 2779 3816 1138 1549 2776 1552 2790 2788 1131 2769 1134 2786 2889 2885 
	1111 1123 2894 2873 1119 2768 1113 1120 2966 2906 2192 
}

equator_y_on_province_image = 856
